<OSS 수강생들의 최애곡 리스트>

박규동 : 아이브 - After Like
윤승재 : 아이유 -무릎
김형빈 : cosmicboy - Can I Love?
박우석 : 아이들-말리지마
이민우 : 최유리 -바다
황희태 : 비와이 -DayDay
김상수 : 태연 -Time Lapse
송인범 : 나플라 -run
18이재원 : 김현식 -비처럼 음악처럼
김현빈 : Michael Jackson -Love Never Felt So Good
이건희 : 김동률-기억의 습작
장지원 : 사우시독 -이츠카
김지수 : The Weeknd - Out of Time
김지훈 : 버즈 - 가시
김주혁 : 폴킴 -안녕
손예지 : 우효 - 민들레
김은비 : 제이레빗 - 선잠
장순우 : 트랜스픽션 - GO
민희원 : LE SSERAFIM - Blue Flame
윤성호 : 임한별 - 넌 나의 전부
안성재 : Royal 44 - 할 것
고석환 : 윤하- 사건의지평선
석은규 : 신지훈 - 내 사랑 내 곁에
이태연 : 리쌍 - 나란 놈은 답은 너다
김주영 : 올티 - 설레
변유진 : 테이 - Monologue
유시영 : 태인 - 마음마음
정태영 : sondia - 어른
문수현 : 먼데이키즈 - 흉터
김수연 : 델리 스파이스 - 고백
이준서 : 박효신 - 야생화
이재민 : COIN - Watering a dead flower
이지은 : 윤하 - 사건의지평선
김승현 : 아이유-비밀의화원
노은선 : 바비-연결고리
정광호 : Glen Hansard - Falling Slowly
하민용 : 아이즈원 - FIESTA
설수빈 : oais - Live Forever
